8
.......0
.00..1..
.0...1.0
..1.....
00.1..1.
....1...
11...0.1
.1.....1